20:20
22222222222222222222
21111111121111211112
21111111121211111112
22222112222222221112
21111111111111111112
21211222222211212112
21211211111211212112
21211211111211212112
21211211111211212112
21211211111211212112
21211211111211212112
21211221112211212112
21111111111111212112
21111111111111212112
21222222222222212112
21111111111111112112
21111111111111112112
21222222222222222112
21111111111111111112
22222222222222222222
